111111111111111111111111
100000P000E000C000000001
111111111111111111111111
