1111111111111111
1E1000000PC00001
1111111111111111