1111
1001111111111111
1001
1111
