1111111111111
11P00000E0011
1111011111111
11110100C0C11
110C000111111
1111111111111