1111111111111111111111111
1111111111111111111111111
11P0011000000000000000C11
1111011011111011111111111
1111011CCCCC1011110000E11
11CC011111111011110111111
111101111111100C110111111
110000000000000C11C000011
1101110111111111111111011
1101110111111111111111011
1101110111111111111111011
1CC1110000000000000000011
1111111111111111111111111
1111111111111111111111111
